aberrant|markedly different from an accepted norm
aberration|a state or condition markedly different from the norm
acolyte|an assistant to a priest or minister in a liturgical service
adherent|someone who believes and helps to spread a doctrine
alabaster|a fine-textured white gypsum used for carving
albatross|a large web-footed bird noted for powerful gliding flight
anechoic|not having or producing echoes; sound-absorbent
anthropic|relating to mankind or the period of mankind's existence
anthropoid|resembling human beings
aplomb|great coolness and composure under strain
assuage|to make less painful
attrition|the act of rubbing together
avail|be of use to, be useful to
avow|declare or affirm solemnly and formally as true
baddie|the principal bad character in a film or work of fiction
beatitude|one of the eight sayings of Jesus at the beginning of the Sermon on the Mount; in Latin each saying begins with `beatus' (blessed)
bestowment|the act of conferring an honor or presenting a gift
billowing|characterized by great swelling waves or surges
billow|a large sea wave
bluster|be gusty, as of wind
bucolic|devoted to raising sheep or cattle
canticle|a hymn derived from the Bible
capitulate|surrender under agreed conditions
chicanery|the use of tricks to deceive someone
clairvoyant|someone who can perceive things not present to the senses
clarion|loud and clear
codified|enacted by a legislative body
conduit|a passage through which water or electric wires can pass
conflagration|a very intense and uncontrolled fire
congeal|solidify, thicken, or come together
convolution|the action of coiling or twisting or winding together
creosote|a dark oily liquid obtained by distillation of coal tar
debonair|having a sophisticated charm
delegate|a person appointed or elected to represent others
denouement|the outcome of a complex sequence of events
desperado|a bold outlaw
despondency|feeling downcast and disheartened and hopeless
diffidence|lack of self-assurance
discomfiture|the act of discomfiting (to defeat in battle) someone
dissipation|breaking up and scattering by dispersion
duress|compulsory force or threat
dysplasia|abnormal development (of organs or cells) or an abnormal structure resulting from such growth
ectoplasm|the outer granule-free layer of cytoplasm
endogenous|having an internal cause or origin
ensconce|fix firmly
eon|the longest unit of geological time
epicine|having characteristics of both sexes or no characteristics of either sex; of indeterminate sex
eviscerate|remove the entrails of
extrication|the act of releasing from a snarled or tangled condition
febrile|of or relating to or characterized by fever
fecundity|the state of being fertile or capable of producing offspring
frippery|something of little value or significance
germinate|sprout; produce buds or branches
gridlock|a traffic jam so bad that no movement is possible
guileless|free of deceit
gyroscopic|having the characteristics of a gyroscope
haggard|British writer noted for romantic adventure novels
heave|lift or elevate
heinous|extremely wicked, deeply criminal
hewn|cut or shaped with hard blows of a heavy cutting instrument like an ax or chisel
immolation|killing or offering as a sacrifice
impunity|exemption from punishment or loss
inchoate|just begun and so not fully formed or developed; rudimentary
incipient|in an initial stage; beginning to happen or develop
incongruous|lacking in harmony or compatibility or appropriateness
incorrigible|impervious to correction by punishment
indelicate|slightly indecent, offensive, or improper
indigent|poor enough to need help from others
infirmity|the state of being weak in health or body
insurrection|organized opposition to authority
inveterate|habitual
irascible|quickly aroused to anger
jive|a style of jazz played by big bands popular in the 1930s
jurisdiction|the territory within which power can be exercised
jurisprudence|the branch of philosophy concerned with the law
lasciviously|in a lascivious manner
Laurel|United States slapstick comedian (born in England) who played the scatterbrained and often tearful member of the Laurel and Hardy duo who made many films (1890-1965)
manacle|shackle that can be locked around the wrist
martyr|one who voluntarily suffers death
mercurial|relating to or having characteristics (eloquence, shrewdness, swiftness, thievishness) attributed to the god Mercury
mirth|great merriment
moiety|one of two approximately equal parts
moniker|a familiar name for a person
moribund|being on the point of death
morose|showing a brooding ill humor
myoma|a benign tumor composed of muscle tissue
nascent|being born or beginning
obsequious|attempting to win favor from influential people by flattery
obviate|do away with
opiate|a narcotic drug
palpitate|beat rapidly
paradigm|a standard or typical example
penchant|a strong liking
perdition|the place or state in which one suffers eternal punishment
perforate|make a hole into or between, as for ease of separation
petrochemical|any compound obtained from petroleum or natural gas
phantasmal|resembling or characteristic of a phantom
phylogenetic|of or relating to the evolutionary development of organisms
placard|a sign posted in a public place as an advertisement
plutocrat|
pomp|cheap or pretentious or vain display
pontiff|the head of the Roman Catholic Church
porcelain|ceramic ware made of a more or less translucent ceramic
portico|porch or entrance to a building consisting of a covered area
prionace|blue sharks
prismatic|of or relating to or resembling or constituting a prism
probity|the quality of having strong moral principles; honesty and decency
propagate|multiply through reproduction
quixoitic|exceedingly idealistic; unrealistic and impractical
rapacity|reprehensible acquisitiveness; insatiable desire for wealth
rapt|feeling great delight
ratiocination|the proposition arrived at by logical reasoning
recompense|make payment to
rectilinear|characterized by a straight line or lines
rectory|an official residence provided by a church for a minister
redolence|a pleasingly sweet olfactory property
redolent|having a strong pleasant odor
redoubt|an entrenched stronghold or refuge
redress|make reparations or amends for
regale|provide with choice or abundant food or drink
relegate|assign to a lower position
reprobate|a person without moral scruples
rescind|cancel officially
resound|emit a noise
respite|a pause from doing something
retinue|the group following and attending to some important person
rhapsody|an epic poem adapted for recitation
sallow|unhealthy looking
saltate|leap or skip, often in dancing
sanctity|the quality of being holy
sartor|a person whose occupation is making and altering garments
senescence|the property characteristic of old age
sepsis|the presence of pus-forming bacteria or their toxins in the blood or tissues
sequester|keep away from others
shoal|a stretch of shallow water
sieve|a strainer for separating lumps from powdered material
silicon|a tetravalent nonmetallic element
sinuous|curved or curving in and out
specter|a ghostly appearing figure
stalwart|having rugged physical strength
staunch|firm and dependable especially in loyalty
subjugate|make subservient; force to submit or subdue
substrate|the substance that is acted upon by an enzyme or ferment
sultry|attractive and suggesting hidden passion
supine|lying face upward
supplicate|ask for humbly or earnestly, as in prayer
surfeit|indulge (one's appetite) to satiety
Surrey|a county in southeastern England on the Thames
tarmac|a paved surface having compressed layers of broken rocks held together with tar
tenure|the term during which some position is held
theophany|a visible manifestation of a deity to a human person
thoroughfare|a public road from one place to another
thrall|the state of being under the control of another person
throng|a large gathering of people
trammel|a restraint that is used to teach a horse to amble
transgression|the violation of a law or a duty or moral principle
transubstantiation|an act that changes the form or character or substance of something
trussed|bound or secured closely
turpentine|volatile liquid distilled from turpentine oleoresin
upbraider|someone who finds fault or imputes blame
vector|a quantity that has magnitude and direction
vehement|marked by extreme intensity of emotions or convictions
velveteen|a usually cotton fabric with a short pile imitating velvet
vitriol|abusive or venomous language to express blame or censure
vocation|the particular occupation for which you are trained
volition|the act of making a choice
wane|a gradual decline (in size or strength or power or number)
wayward|resistant to guidance or discipline
welter|a confused multitude of things